111111111111111111111111111111111111111111111111111111111111111111111111111111111
100C00000000000000000000000000000000000000000000100000000000000000000000000000001
100C00000000000000000000000000000000000000000000100000000000000000000000000000001
100C00000000000000000000000000000000000000000000100000000000000000000000000000001
100C00000000000000000000000000000000000000000000100000000000000000000000000000001
100C00000000000000000000000000000000000000000000100000000000000000000000000000001
1000C0000000000000000000000000111111111111111111100000000000000000000000000000001
1000000000000000E0000000000000000000000000000001000000000P00000000000000000000001
1000C0000000000000000000000000000000000000000000100000000000000000000000000000001
100C00000000000000000000000000000000000000000000010000000000000000000000000000001
111111111111111111111111111111111111111111111111111111111111111111111111111111111
