1111111111111111111111
1P0100010000C000010E01
1001010100000000010001
1011010101111000010001
1000010001111010010001
111011101C000010001011
1C0000C1C000001C000001
1111111111111111111111